[
  "..........",
  ".#....M...",
  "..#.......",
  ".....#....",
  "...S..#..U",
  ".....#....",
  "...W......",
  "..........",
  "....U.....",
  "..M...#..."
]
